111111111111111111111111111111111111111111111111111111111111111111111111111111111
122202222222222222222222022222222202222222222222222222022222220222222222220222221
100202000000020200000000020000020002000000020000000002020002000202000000020200021
122202222222020202222222220222220222022222220222222202020202022202222222020202021
120000020000020202000000000200000200020000000200020002020202020000000002000202021
120222020222220202220222220222022202022202222202020222022202020222222202222222021
120200020200000000020000020002020002000200000202020200000002020002000200000002021
120222020222022222220222022202022202220222220202220202222222022222020222022202021
120202020002020000000202020202000202020000020202000202000002000000020002020200021
120202220202220222222202020202222202022222020202220222022202220222222222020222221
120000020200000002000002020000000002020000020200020002020200000200000000020000021
120222020222222222022222022222220222020222220202220222020222222202222222020222221
120202020200000000020000020002020202000200000200000200020000000000020002020002001
122202022202222222222222020222020202220202222222220222020222220222022202022202221
100002000002000000000002000200000200020200020000020002020202020202000002000200001
122202222202022222222202220222222222020222022222022222020202020202222222220222221
120200000200020000000200020002000000020002000000000000020002020200000000000000021
120222220222020222022202022202222202222202022222220222220222020222222222222202221
120002000002020002020002000200000002000002020000020200000200020000000000020202021
122202222202220222022202220222022222022222022202022202222202220222222222220202021
100200020000000200000202020002020002020000000202000000000200020200000002000002001
120222022202222202220202022202220222020222220222020222220222022202222202022202221
120002000202000202020202000200000200020200020002020202020202000202000200020202021
122202020202220202022202220202222222022202222202022202020202220202220202220202021
120002020202000202000000000202000000000002000002000002020200020200020202000202021
122222020222022202222222220202020222222222022222220222020202220222020222020202021
120000020000020000000000020202020200000000020000020200020202000002020000020200021
120222222222020222222222020202020222022222020222022202020202022222022222020202221
120002000002020202000000020202020002020002020202000002020202020000000002020202021
122202022222020202222222220222022202020202220202222202020202022222022222020222021
100202000000020200000000000002000202020200000200000202020002000200020000020000021
120202222222022202222222022202222202222222022202022202020222022202220222220222021
120200000002000002000002020200020000020000020002020002020200020002000002020202021
122202222222222222022202220222020222020222220222220222022202222202022202022202221
120002000000000000020200000002000202000200000200000200000002000002020200020000001
120222022222222222220202222202222202222202220202222222022202220222020222022202221
120200000000020000000202020000000000000002020200020002020200020200020002000200021
122202222222220222220202022222222222222222020222022202020222020222220222022202221
100002000000000200020200000000000000020200000002020002020200020000000200020002001
122222022222222202220202222222022222020202222222020222020202220222022202222202221
120000020002020000000202000002020002020002000000020200020202000002020000000200021
120222222202020222220202022222220202022202022202220202220202222202022222220222221
120000000202000200020202000000000202020202020202000202000200000202000000020000021
120222022202222222020202222222022202020202020202220202220222220222022222022222021
120202000200000000020200000202020202000202020200020200020002000002020002000002021
122202220202222222220202220202020222222202020202220222020202222222220222222202021
100000020002000000000202020002020000000002020002000002020200000000000000000202021
122222220222022222220202022222020202222222022222022202022202222222022222220202021
120000000202020000020202000000020202000000000000020202000200020200020000020002001
120222222202020222022202022222222202220222222222220202222222220202220222022202221
120000000200020200000002000000000200020002000000000202000002000002000200000200021
122222220222020202222222222222220222022222022202222202022202022202020222220222021
120000020002020202000000000000020002000000000202000000020200020202020200020002021
120222022202220222220222220222220202022202222202220222220222220222020222022202021
120002000202000200000200020200000202020202020000020202000000000000020002020202021
122222220202220202222202220202222202220202022202220202222222220222222202020202021
120000000200020002000002000202020000000202000202000200000000020000000202020002021
120222222202022222022202220202022202220202020222022222222202022202220202022202021
100200000002000000020000020200000202020202020000000200000202000202020202000202021
122202022222222202222222020222220222022202220222220202220202220222020202020222021
120002020002000002000202020002020000000000020200020202020202020000020202020000021
120222222202222202220202022202022222222222022202220202020222020222220202220202221
120000000200000200020202000202000000000002000002000002020000000200000200020202021
122222220202220202220202020202222222222202222202222202022202220202022202220222021
120000020202000202000202020200000002000002020200000202000202020202020202000000021
120222020222022202022202220222220202022202020222020202220222022202220202222202221
120200020002020002020000000000020202020200020002020202020000000002000200000202001
120222020222020222022222222222020222020222220202220202022202022222022202222202221
120002020000020200000200000202020000020000000202000202000202020000020202000000021
120222022222022202220222022202020222020222220222022202022202020222220202222202221
120202000002000002020000020000020202020200020200020000020002020200000200000202021
122202020222022222020222022222222202220222020202220222220222220222220202220222021
100002020202020000020202000000000000020002020002000002000200000000020200020000021
120222020202022222022202022222222222022202022222022222020202222222020222222222021
120200020200000002000002020000000002000002000000020000020200000002020000000002021
120222020202222202022222022202222202222202220222220222220222222222022222022202021
120002020202020002020200000202000200000200020200000200000000000002000002020200021
122202020222020222020202220202220222222222020202022202222222222202020222020222221
120202020000020200020002020200020000000000020202020202000000020002020200020000001
120222222222022222022222022222022222222222222202220222222222022222220222222222221
111111111111111111111111111111111111111111111111111111111111111111111111111111111
